Season,Age,Tm,Lg,Pos,G,GS,MP,FG,FGA,FG%,3P,3PA,3P%,2P,2PA,2P%,eFG%,FT,FTA,FT%,ORB,DRB,TRB,AST,STL,BLK,TOV,PF,PTS
2009-10,20,OKC,NBA,SG,76,0,1738,233,578,.403,93,248,.375,140,330,.424,.484,194,240,.808,47,197,244,137,80,20,106,200,753
2010-11,21,OKC,NBA,SG,82,5,2189,298,684,.436,113,324,.349,185,360,.514,.518,289,343,.843,42,213,255,176,92,24,106,207,998
2011-12,22,OKC,NBA,SG,62,2,1946,309,629,.491,114,292,.390,195,337,.579,.582,312,369,.846,30,222,252,229,62,15,137,150,1044
2012-13,23,HOU,NBA,SG,78,78,2985,585,1337,.438,179,486,.368,406,851,.477,.504,674,792,.851,62,317,379,455,142,38,295,178,2023
2013-14,24,HOU,NBA,SG,73,73,2777,549,1205,.456,177,483,.366,372,722,.515,.529,576,665,.866,61,283,344,446,115,29,265,177,1851
2014-15,25,HOU,NBA,SG,81,81,2981,647,1470,.440,208,555,.375,439,915,.480,.511,715,824,.868,75,384,459,565,154,60,321,208,2217
2015-16,26,HOU,NBA,SG,82,82,3125,710,1617,.439,236,657,.359,474,960,.494,.512,720,837,.860,63,438,501,612,139,51,374,229,2376
2016-17,27,HOU,NBA,PG,81,81,2947,674,1533,.440,262,756,.347,412,777,.530,.525,746,881,.847,95,564,659,907,121,38,464,215,2356
2017-18,28,HOU,NBA,SG,72,72,2551,651,1449,.449,265,722,.367,386,727,.531,.541,624,727,.858,41,348,389,630,126,50,315,169,2191
2018-19,29,HOU,NBA,PG,78,78,2867,843,1909,.442,378,1028,.368,465,881,.528,.541,754,858,.879,66,452,518,586,158,58,387,244,2818
Career,,,NBA,,765,552,26106,5499,12411,.443,2025,5551,.365,3474,6860,.506,.525,5604,6536,.857,582,3418,4000,4743,1189,383,2770,1977,18627